//wait	startindex	R,G,B Colors...
17	17	248,224,104	240,168,40	216,96,8
17	17	248,224,112	240,168,48	216,104,8
17	17	248,232,112	240,176,48	216,112,8
17	17	248,240,104	240,184,40	224,120,16
17	17	248,240,104	248,184,40	232,128,16
17	17	248,232,104	248,176,48	216,104,8
