FE8 - Fields - 01000203
19 17
615 452 587 517 620 418 481 718 720 164 163 782 849 946 65 782 164
554 422 550 523 587 422 618 560 817 684 782 44 71 130 131 131 206
584 423 553 417 550 424 560 720 98 98 98 98 102 807 808 809 144
480 424 553 747 560 751 647 99 198 273 273 199 720 839 840 841 270
583 425 528 783 783 720 202 262 433 305 305 307 98 871 872 873 300
779 747 560 99 99 165 264 401 433 199 782 782 98 817 230 199 99
775 688 782 99 99 198 433 433 401 297 130 98 98 720 67 230 337
66 720 98 98 782 144 433 433 433 265 162 782 395 132 720 723 721
199 720 782 165 782 270 433 433 305 231 721 818 368 199 782 946 946
292 275 267 162 164 230 305 231 783 720 782 946 230 231 782 66 130
162 300 325 203 132 720 817 784 723 130 99 782 67 721 98 720 782
720 66 234 235 98 98 720 848 849 130 98 98 782 946 720 932 66
275 98 98 98 78 75 44 71 162 98 720 782 130 131 131 99 66
401 263 203 130 168 137 70 6 45 98 98 130 807 808 809 130 782
305 433 201 269 720 102 111 167 743 99 99 162 839 840 841 720 165
721 230 305 231 848 98 66 591 424 497 99 98 871 872 873 74 816
787 753 782 98 98 98 384 418 618 492 497 106 106 396 67 106 848
944 786 783 98 98 98 495 456 429 551 545 593 130 368 199 98 384
817 783 99 140 75 782 594 160 580 514 457 718 784 230 231 493 424
