style -   - 0018191A
28 28
212 534 452 453 456 424 424 424 424 424 457 820 458 720 419 720 458 820 531 183 212 534 784 785 459 784 785 785
884 484 823 825 520 747 747 747 747 747 521 820 458 720 722 721 458 820 531 183 212 534 784 785 459 784 419 784
850 423 820 821 458 912 910 913 910 911 458 820 552 426 451 426 553 820 484 884 884 484 784 785 458 784 786 785
849 519 820 821 458 944 942 624 942 946 458 820 824 824 824 824 824 821 421 819 853 421 785 785 490 784 552 426
514 502 820 821 458 688 690 625 691 689 458 820 821 821 821 821 821 821 422 848 849 422 785 785 866 451 866 866
181 534 820 719 458 723 688 627 689 723 458 820 719 820 821 821 821 821 499 513 514 502 784 785 786 786 786 786
212 534 820 815 458 784 722 786 722 785 458 820 815 858 821 499 564 564 566 151 181 534 784 785 785 785 785 785
212 534 820 821 552 427 784 721 785 428 553 820 456 457 821 531 214 182 182 245 212 534 784 785 520 426 426 426
212 534 820 821 866 866 452 454 453 866 866 820 456 457 821 531 183 212 212 212 212 534 784 719 458 723 722 722
565 566 820 821 961 961 452 454 453 960 960 820 552 553 821 531 183 212 499 564 564 566 784 783 458 720 33 720
824 824 821 821 824 824 824 824 824 824 824 821 821 821 821 531 183 212 534 787 786 786 785 785 458 720 722 419
719 820 821 821 821 821 821 821 821 821 821 821 821 719 820 496 183 212 496 784 719 784 785 785 458 720 33 720
815 858 821 520 426 426 426 521 820 821 484 820 821 815 858 531 183 212 534 784 783 754 785 785 458 720 722 721
820 821 821 458 723 722 722 458 820 821 742 452 453 563 564 566 183 212 563 564 564 502 784 785 484 426 416 426
820 821 821 458 720 33 720 458 820 821 423 151 181 185 186 182 212 212 182 182 182 534 784 785 742 866 451 866
820 719 820 458 720 722 721 458 820 821 519 183 213 249 250 212 212 212 212 212 212 534 784 785 786 786 786 786
820 815 858 484 416 426 426 484 820 821 484 563 564 564 564 502 183 212 683 183 212 534 784 785 785 785 785 785
820 821 821 742 451 866 866 742 820 821 742 866 866 866 866 531 183 212 505 216 212 534 784 785 785 785 785 785
820 821 821 824 824 824 824 824 821 821 824 824 824 824 824 531 183 212 569 212 212 564 564 484 452 454 453 484
820 821 821 821 821 821 821 821 821 821 821 821 821 821 821 531 183 212 212 212 212 182 182 556 848 849 849 186
564 564 564 564 564 502 820 821 821 821 821 821 821 821 821 531 183 212 212 212 212 212 212 556 848 849 849 250
182 182 182 182 182 502 820 821 719 820 821 821 719 820 821 484 884 884 484 564 564 564 564 484 452 454 453 484
212 212 212 212 212 534 820 821 815 858 821 821 815 858 821 421 819 853 423 823 824 824 824 742 823 824 824 742
564 564 502 212 212 534 820 821 458 820 719 820 458 820 821 422 848 849 519 820 821 719 820 821 821 821 821 821
824 824 502 216 212 534 820 821 459 820 815 858 458 820 821 499 513 514 502 820 821 815 858 821 821 821 821 821
821 821 496 216 212 496 820 821 459 452 454 453 458 820 821 531 151 181 534 820 821 484 426 583 452 454 453 583
821 821 534 216 212 534 820 456 457 452 454 453 456 457 820 531 183 212 534 820 821 458 867 615 874 844 844 615
821 821 534 216 212 534 820 456 457 452 454 453 456 457 820 531 183 212 534 820 821 458 963 647 876 842 842 647
