style -   - 0018191A
20 24
426 426 426 521 452 453 458 820 821 821 531 184 212 534 452 453 456 424 424 424 424 424 457 820
419 723 722 459 452 453 458 820 719 820 484 884 884 484 823 824 520 746 746 746 746 746 521 820
722 33 720 459 823 824 490 820 815 858 421 819 850 423 820 821 458 912 910 913 910 914 458 820
721 33 720 459 820 821 824 821 821 821 422 848 849 519 820 821 458 944 942 945 942 946 458 820
419 723 721 459 820 821 821 821 821 821 499 513 514 502 820 821 458 688 690 625 691 689 458 820
426 426 448 484 820 821 499 564 564 564 566 151 181 534 820 719 458 723 688 627 689 723 458 820
866 866 451 742 820 821 531 214 182 182 182 213 212 534 820 815 458 784 722 786 722 785 458 820
824 824 824 824 821 719 531 184 212 212 212 212 212 534 820 821 552 427 784 721 785 552 553 820
821 821 821 821 821 815 531 184 212 499 564 564 564 566 820 821 866 866 452 454 453 866 866 820
563 564 497 564 564 564 566 184 212 534 823 824 824 824 821 821 960 960 452 454 453 960 960 820
186 182 182 182 182 182 182 212 212 534 820 821 719 820 821 821 824 824 824 824 824 824 824 821
250 212 212 212 212 212 212 212 212 534 820 821 815 858 821 821 821 821 821 821 821 821 821 821
563 564 497 564 564 564 502 184 212 563 564 502 820 821 821 520 426 426 426 521 820 821 484 820
824 824 824 824 824 824 531 184 212 182 182 534 820 821 821 458 723 722 722 458 820 821 742 452
821 719 820 821 821 821 531 184 212 212 212 534 820 821 821 458 720 33 720 458 820 821 423 151
821 815 858 821 821 821 563 564 484 884 884 484 820 719 820 458 720 722 721 458 820 821 519 183
821 821 821 583 820 821 824 824 421 819 850 423 820 815 858 484 448 426 426 484 820 821 484 563
452 454 453 615 820 821 821 821 422 848 849 519 820 821 821 742 451 866 866 742 820 821 742 866
452 454 453 647 820 719 820 821 499 513 514 502 820 821 821 824 824 824 824 824 821 821 824 824
452 454 453 775 820 815 858 821 531 151 181 534 820 821 821 821 821 821 821 821 821 821 821 821
