style -   - 006CA36E
23 25
772 772 772 772 772 772 772 772 772 772 805 468 906 469 804 772 805 918 981 694 848 694 981 950 436
772 772 772 772 772 805 33 436 804 772 869 468 469 932 815 772 805 436 437 266 880 266 437 437 469
774 815 772 805 723 724 379 468 838 695 265 266 267 437 932 815 772 805 468 298 437 298 469 469 469
917 868 815 805 212 212 212 468 306 695 297 298 299 469 437 868 774 901 468 298 469 298 469 469 469
437 917 868 815 805 212 212 468 437 437 469 806 468 469 469 949 981 804 816 933 469 932 815 468 469
469 437 917 868 774 869 436 469 816 777 469 804 805 468 469 437 668 804 805 436 469 437 868 774 774
906 469 437 918 981 919 468 804 805 436 469 804 772 805 468 469 437 932 805 468 469 469 437 437 437
469 695 265 266 267 437 469 838 806 306 468 932 774 933 468 932 933 436 869 468 469 469 939 469 906
772 695 297 298 299 469 469 917 806 436 469 438 918 950 468 949 950 468 437 469 469 469 971 939 469
772 805 468 868 869 468 469 306 806 468 469 806 436 305 668 307 437 469 469 469 469 469 469 971 804
981 950 468 918 950 806 468 437 838 468 804 772 805 337 338 339 469 469 469 469 806 468 469 932 815
437 437 469 437 668 838 468 469 437 900 774 809 869 272 274 806 468 469 900 694 694 694 933 436 932
469 469 469 469 437 437 838 208 211 806 436 838 436 932 774 815 805 468 838 305 668 307 437 469 437
772 805 468 469 469 469 437 241 243 838 468 504 503 668 436 932 901 468 437 305 338 339 469 804 805
772 816 869 468 469 804 805 272 275 469 504 475 198 506 505 437 838 468 469 337 338 806 468 900 933
816 933 436 469 804 772 774 662 662 469 469 806 410 804 805 469 437 469 469 469 932 933 468 838 436
805 1017 468 804 772 805 436 437 437 306 468 932 809 774 774 774 933 468 469 469 437 437 469 437 469
933 436 469 804 772 772 805 468 469 437 469 469 838 918 981 950 436 469 469 469 469 469 469 469 469
1017 468 469 437 868 809 774 774 774 774 774 901 436 306 436 305 338 932 806 468 469 932 901 468 469
437 469 469 469 917 807 918 919 700 701 702 868 901 436 469 305 306 307 932 933 468 668 932 901 468
469 469 469 469 437 838 668 436 976 668 978 437 807 468 469 337 338 339 437 437 806 436 469 932 815
469 469 469 939 469 437 437 469 1008 1009 1010 804 772 805 468 662 662 662 468 469 806 468 469 33 804
469 469 469 971 469 469 469 900 662 662 662 804 772 805 468 870 871 871 806 468 804 772 772 772 772
