style -   - 00010203
22 20
807 808 809 914 274 293 679 944 946 652 653 644 643 594 524 545 528 775 776 777
839 840 841 946 396 816 785 642 643 774 640 685 130 704 594 747 592 652 677 738
871 872 873 260 293 815 640 932 384 690 658 743 932 643 784 785 740 468 199 268
198 293 130 238 130 685 768 384 524 426 614 481 497 653 641 673 437 305 305 231
307 742 686 467 130 206 782 594 524 491 813 491 465 782 737 130 238 70 79 135
384 545 550 750 783 306 261 640 594 525 714 583 780 652 675 208 209 142 114 111
524 426 613 657 848 817 238 674 652 653 778 651 745 673 229 268 203 640 738 643
524 491 582 616 497 815 74 75 672 673 932 800 673 782 130 270 237 198 275 130
583 524 549 545 465 130 108 81 14 672 740 468 274 209 720 292 337 293 230 261
545 550 715 622 592 880 817 102 111 45 208 305 295 816 785 130 644 641 130 396
747 560 70 45 784 946 384 750 784 817 130 742 784 815 642 738 74 140 208 231
70 79 169 268 272 267 559 545 593 782 384 427 497 640 130 684 953 954 955 75
143 172 107 306 401 265 130 751 784 946 594 459 592 736 688 108 985 986 987 109
167 783 674 197 230 231 130 141 70 45 130 558 130 768 772 163 46 968 46 130
99 848 785 736 44 932 70 111 103 782 130 130 130 208 436 469 130 396 776 777
99 204 275 672 130 102 103 784 882 130 130 784 785 130 230 305 261 292 261 130
783 236 401 199 674 706 706 505 849 130 720 204 401 209 130 130 238 130 306 337
815 785 300 301 132 132 236 231 66 208 263 200 271 782 642 738 130 206 130 130
207 203 99 720 817 204 199 784 785 66 230 305 231 640 679 653 204 271 130 384
306 265 99 815 849 236 501 738 645 66 782 15 75 704 652 198 443 231 130 495
882 230 273 199 99 640 70 79 71 720 136 6 143 672 130 306 176 269 130 594
721 882 270 401 205 736 142 932 6 79 6 6 103 228 672 130 230 401 209 130
