style -   - 003C3D3E
28 24
424 650 427 553 820 821 552 461 553 820 821 552 592 426 427 427 426 427 427 426 521 2 230 147
424 457 823 824 821 821 824 558 823 821 821 656 624 657 823 551 555 554 554 554 458 2 198 337
424 457 820 821 821 821 821 590 820 821 821 688 627 689 820 486 823 825 824 419 458 2 402 724
584 484 820 821 821 484 585 424 424 489 820 821 821 821 821 486 820 719 821 824 458 2 485 230
457 516 452 454 453 516 488 424 584 484 820 821 484 461 427 429 820 814 821 719 458 2 581 194
553 823 824 824 824 824 552 427 553 516 452 453 516 458 823 825 821 821 821 814 490 34 198 728
423 820 821 719 820 821 824 825 824 824 825 825 824 458 419 820 719 820 821 821 421 262 307 100
422 820 821 814 852 822 821 822 821 821 821 821 821 458 823 821 814 852 821 821 486 794 66 70
457 820 821 520 576 545 545 578 521 820 821 821 821 552 427 427 556 557 426 427 427 427 427 427
457 820 822 491 640 611 611 610 458 820 821 821 821 824 824 825 824 824 825 824 824 825 824 421
457 820 719 458 640 611 611 610 458 820 821 821 821 822 821 822 821 822 822 821 821 821 821 486
457 820 814 491 672 673 673 674 458 820 821 821 821 520 576 545 545 545 578 521 820 719 520 427
553 820 821 552 484 417 418 484 427 427 820 821 427 493 640 611 611 611 610 459 820 814 458 555
824 821 821 523 516 452 453 516 522 555 556 557 554 458 640 611 611 611 642 491 820 822 458 34
719 820 821 825 824 824 825 824 824 825 825 825 825 458 672 673 673 673 674 459 719 820 552 521
814 852 821 821 821 821 821 719 820 821 821 719 820 484 416 484 426 427 426 553 813 852 551 555
821 822 822 821 821 821 821 814 852 821 821 814 852 516 420 516 555 554 554 554 820 821 486 421
553 452 453 552 426 521 820 458 820 821 821 458 820 824 824 824 824 825 824 825 821 821 486 486
517 793 794 518 517 458 820 458 452 454 453 458 820 822 821 822 821 821 822 821 821 822 520 426
269 132 98 168 6 458 419 458 452 454 453 458 419 520 427 427 427 427 427 427 427 427 553 518
724 263 269 108 6 552 427 484 452 454 453 484 427 553 518 517 517 517 517 517 517 517 517 34
337 337 339 131 172 517 517 516 727 194 396 516 518 517 3 3 4 761 273 273 696 696 696 261
337 724 337 762 194 3 3 3 296 273 297 3 3 3 198 665 273 337 726 337 209 485 75 396
230 337 337 337 371 260 696 696 337 337 237 140 485 77 729 337 337 794 300 292 261 581 175 338
131 306 724 337 726 339 76 485 178 794 99 142 581 175 300 304 301 66 194 132 396 166 109 729
99 194 230 337 337 730 108 581 109 99 164 166 111 109 194 70 79 71 98 761 339 100 198 337
194 70 485 230 337 337 273 696 261 98 485 71 194 70 79 6 485 169 198 337 792 162 729 337
74 38 581 194 729 337 297 194 396 66 581 6 79 167 110 166 581 175 729 339 194 206 230 724
